C 0,50,120
F 255,0,255
NO ./images/colorstone.png
SO ./images/graystone.png
WE ./images/mossystone.png
EA ./images/redbrick.png



1111111111111111111111111
      10000110000000000001111111
11111111011000001111110000000001
        1001000000000000000000001
111111111011000001110000000000001
100000000011000001111110100111111

11111111111111011100000000001
11110111111111011101010010001
11000000111 11011100000010001
1000000000111000000W000010001
10000000000000001101010010001
1100000111010101111101111000111
11110111 1110101 101111010001
11111111 1111111 111111111111
