NO ./images/colorstone.png
SO ./images/graystone.png
WE ./images/mossystone.png
EA ./images/redbrick.png

F 220,100,0
C 225,30,0


111111111111111111
100000000000000001
100000000001000001
1000100000000000N1
100000000000000001
100000000000000001
111111111111111111
