NO ./images/north.png
SO ./images/south.png
WE ./images/west.png
EA ./images/e.png

C 0,50,120
F 100,100,100


11111111
10000001
10S00001
1000001
11111111