NO ./images/colorstone.png
SO ./images/graystone.png
WE ./images/mossystone.png
EA ./images/redbrick.png

C 0,50,120
F 100,100,100

 11111111 
 11000000 
 1000N011 
 10000001 
 11111111 
          