NO ./images/colorstone.png
SO ./images/graystone.png
WE ./images/mossystone.png
EA ./images/redbrick.png

C 0,50,120
F 100,100,100

 1111111111
 1101 1000000001 
 10001011111111 
 10N00001
 11111111 
          